8 6 5 4 3 2 1 2 3 3
8 9 10 11 12 13 14 15 16 18 19
8 6 5 4 3 21 1 2 3 3
8 6 5 4 3 2 1 2 3 3
8 6 5 4 3 2 1 2 3 3
1 0 0 0 1 0 2 2 3 3
1 0 0 0 1 0 2 2 3 3
1 0 0 0 1 0 2 2 3 3
1 0 0 0 1 0 2 2 3 3
1 0 0 0 1 0 2 2 3 3
e
1 0 1 1 1 0 0 0 0 1
1 0 1 1 1 0 0 0 0 1
1 0 1 1 1 0 0 0 0 1
1 0 0 0 0 0 0 0 0 1
1 0 1 0 0 0 0 1 0 1
1 0 1 0 0 0 0 1 0 1
1 0 1 0 0 0 0 1 0 1
1 0 1 0 0 0 0 1 0 1
1 0 1 1 0 0 0 1 0 1
1 0 0 0 0 0 0 0 0 1